Отличителност   -   distinction
Факултетен номер    -   faculty_number
Статус на КСК   -   status_of_ksk
№ на заповед за записване   -   n_of_enrollment_order
Име Презиме Фамилия     -   names
ЕГН     -   egn
редактиране
Имена на латиница   -   names_latin
Телефон     -   phone_number
Имейл       -   email
Пред. Учебно Заведение      -       in_front_of_school
Местонахождение на преходното учебно заведение      -   location_of_the_transitional_educationa_institution
Професионално направление/ квалификация     -   professional_qualification
Потвърждение от Нацид       -   confirmation_by_nacid
Желана Специалност      -   desired_major
Желана форма        -   desired_shape
Продължителност на обучение и дали съкращава    -   length_of_study
КОХОРТ В МООДЛЕ     -       cohort_in_moodle
Начин на кандидатстване     -    method_of_application
Дата на първоначален контакт    -    date_of_initial_contact
Месец на запитване      -       month_of_inquiry
Източник на контакт     -      contact_source
Заплатил КСК            -      paid_ksk
Дата плащане КСК        -       date_of_payment_ksk
Коментар - документи за КСК         -      comment_ksk
Платена сем. такса              -      weekly_fee_paid
Дата на платена сем. такса      -      date_of_paid_weekly_fee
Период на подаване в АдминУни       -      submission_period_in_adminuni
Учебна година                       -       school_year
Дата на издаване на договор             -         contract_issue_date
Сем. Такса                          -       sem_Fee
Отстъпка                            -       discount
Коментар                            -       comment
Изпратен фак. номер                 -       sent_faculty_number
G-mail                              -       university_email
Създаден профил в Мудъл             -       moodle_profile_created
Изпратен имейл за достъп до Мудъл   -       email_sent_to_access_moodle
Вкаран в Кохорт                     -       entered_into_cohort
Въведени в Админ                    -       entered_in_admin